+-+-------------+---------+------------+
|               |         |            |
+-+             |         |  WWWWWWWWWWW
|     +-+       |            W   +-----+
|     |1|       |         |  W   |     |
|     |         |         |  W         |
|     +-+       |         |  W   |     |
|               +------- -+  W   +-----+
|   WWWWWWWWWWWWWWWWWWWWWWWWWW         |
|  WWWWWW     +--------- ---+          |
|  WWWWWW     |             |          |
|  WWWWWW     | 2           |          |
|  WWWW       |             |      +---+
|   WW        |             |      |    
|   W                       |      |
|   W         |             |      |
|   W         |             |      |
+-+WW         |             |      |
  |W          |             |      |
  +W----------+-------------+------+
1:01000001:1:2
2:0054AAF0
